G G G R R G G G G G G G G G G G G G G G
G G G R R G G G G G G G G G G G G G G G
G G G R R G G G G G G G G G G G W W G G
G G G R R G G G G G G G G G G G W W G G
G G G R R G G G G G G G G G G G G G G G
G G G R R R G G G G G G G G G G G G G G
G G G G R R R G G G G G G G G G G G G G
G G G G G R R R G G G G G G G G G G G G
G G G G G G R R G G G G G G G G G G G G
G W W G G G R R G G G G G G G G G G G G
G W W G G G R R G G G G W G G G G G G G
G G G G G G R R G G G W W W G G G G G G
G G G G G G R R G G W W W W W G G G G G
G G G G G G R R G G G W W W G G G G G G
G G G G G G R R G G G G W G G G G G G G
G G G G G G R R G G G G G G G G G G G G
G G G G G G R R G G G G G G G G G G G G
G G G G G G R R G G G G G G G G G G G G
G G G G G G R R G G G G G G G G G G G G
G G G G G G R R G G G G G G G G W W G G
G G G G G G R R G G G G G G G G W W G G
G G G G G G R R G G G G G G G G W W G G
G G G G G G R R G G G G G G G G W W G G
G G G G G G R R G G G G G G G G W W G G
G G G G G G G G G G G G G G G G W W G G
G G G G G G G G G G G G G G G G W W W W
G G G G G G G G G G G G G G G G W W W W
G G G G G G G G G G G G G G G G G G G G
G G G G G G G G G G G G G G G G G G G G
